                              $           $                           
                              $           $                           
                              $           $                           
                              $           $                           
                              $           $                      *    
                              @@@@@@@@@@@@@                  @@@@@@@@@
  @@@@@@      @@@@@@@@@@@     %%%%%%%%%%%%%      @@@@@@@@@   %%%%%%%%%
  %%%%%%      %%%%%%%%%%%                        %%%%%%%%%   %%%%%%%%%
  %%%%%%      %%%%%%%%%%%                        %%%%%%%%%   #########
  ######          ###                            #########   #########
  ######          ###                            #########   #########
  ######          ###                            #########   #########
  &&&&&&          &&&                            &&&&&&&&&   &&&&&&&&&